10
10
80
##########
S       ##
## # #####
## #     #
## ##### #
## #     #
## # #####
## # #####
##       D
##########

